WWWWWWWWWWWWWWW.............................................................................................................................................................................................................................................................................................................................................................................................................................................................................................................................................................................................................................................................
WWWWWWWWWWWWWWW.............................................................................................................................................................................................................................................................................................................................................................................................................................................................................................................................................................................................................................................................
WWWWWWWWWWWWWWW.............................................................................................................................................................................................................................................................................................................................................................................................................................................................................................................................................................................................................................................................
WWWWWWWWWWWWWWW.............................................................................................................................................................................................................................................................................................................................................................................................................................................................................................................................................................................................................................................................
WWWWWWWWWWWWWWW.............................................................................................................................................................................................................................................................................................................................................................................................................................................................................................................................................................................................................................................................
WWWWWWWWWWWWWWW........................................................................................................WW..WWWWWWWWWWW........................................................................................................................................................WWWWWWWWWWW............................................................................................................................................................................................................................................WWWWWWWWWWW............................................................................................................
WWWWWWWWWWWWWWW..................................................................................................WWW.......WWWWWWWWWWW........................................................................................................................................................WWWWWWWWWWW............................................................................................................................................................................................................................................WWWWWWWWWWW............................................................................................................
WWWWWWWWWWWWWWW.............................................................................................WW.............WWWWWWWWWWW........................................................................................................................................................WWWWWWWWWWW............................................................................................................................................................................................................................................WWWWWWWWWWW............................................................................................................
WWWWWWWWWWWWWWW............................................................................................................WWWWWWWWWWW........................................................................................................................................................WWWWWWWWWWW............................................................................................................................................................................................................................................WWWWWWWWWWW............................................................................................................
WWWWWWWWWWWWWWW...........................................................................................WW..WA...........WWWWWWWWWWW........................................................................................................................................................WWWWWWWWWWW............................................................................................................................................................................................................................................WWWWWWWWWWW............................................................................................................
WWWWWWWWWWWWWWW............................................................................................................WWWWWWWWWWW........................................................................................................................................................WWWWWWWWWWW............................................................................................................................................................................................................................................WWWWWWWWWWW............................................................................................................
WWWWWWWWWWWWWWW..............................................................................................WWWW..........WWWWWWWWWWW........................................................................................................................................................WWWWWWWWWWW............................................................................................................................................................................................................................................WWWWWWWWWWW............................................................................................................
WWWWWWWWWWWWWWW.....................................................................................................WA.....WWWWWWWWWWW........................................................................................................................................................WWWWWWWWWWW............................................................................................................................................................................................................................................WWWWWWWWWWW............................................................................................................
WWWWWWWWWWWWWWW............................................................................................................WWWWWWWWWWW........................................................................................................................................................WWWWWWWWWWW............................................................................................................................................................................................................................................WWWWWWWWWWW............................................................................................................
WWWWWWWWWWWWWWW......................................................................................................WW....WWWWWWWWWWW........................................................................................................................................................WWWWWWWWWWW............................................................................................................................................................................................................................................WWWWWWWWWWW............................................................................................................
WWWWWWWWWWWWWWW............................................................................................................wwwwwwwwWWW........................................................................................................................................................WWWWWWWWWWW............................................................................................................................................................................................................................................WWWWWWWWWWW............................................................................................................
WWWWWWWWWWWWWWW..........................................................................................................WWWWWWWAwwWWW........................................................................................................................................................WWWWWWWWWWW............................................................................................................................................................................................................................................WWWWWWWWWWW............................................................................................................
WWWWWWWWWWWWWWW............................................................................................................WWWwwwwwWWW........................................................................................................................................................WWWWWWWWWWW............................................................................................................................................................................................................................................WWWWWWWWWWW............................................................................................................
WWWWWWWWWWWWWWW............................................................................................................WWWwwwwWWWW........................................................................................................................................................WWWWWWWWWWW............................................................................................................................................................................................................................................WWWWWWWWWWW............................................................................................................
WWWWWWWWWWWWWWW............................................................................................................WWWww1WWWWW........................................................................................................................................................WWWWWWWWWWW............................................................................................................................................................................................................................................WWWWWWWWWWW............................................................................................................
WWWWWWWWWWWWWWW............................................................................................................WWwwAWWWWWW........................................................................................................................................................WWWWWWWWWWW............................................................................................................................................................................................................................................WWWWWWWWWWW............................................................................................................
WWWWWWWWWWWWWWW.............................................................................................................wwwwWWWWWW........................................................................................................................................................WWWWWWWWWWW............................................................................................................................................................................................................................................WWWWWWWWWWW............................................................................................................
WWWWWWWWWWWWWWW.........................................................................................................WWWWWWWWWWWWWW........................................................................................................................................................WWWWWWWWWWW............................................................................................................................................................................................................................................WWWWWWWWWWW............................................................................................................
WWWWWWWWWWWWWWBB...................................BBbbBBB.........................................................WW......WWWWWWWWWWW........................................................................................................................................................WWWWWWWWWWW............................................................................................................................................................................................................................................WWWWWWWWWWW............................................................................................................
WWWWWWWWWWWWWWPPBB................................BBWWwWWBB................................................................wWWWWBBWWWW........................................................................................................................................................WWWWWWWWWWW............................................................................................................................................................................................................................................WWWWWWWWWWW............................................................................................................
WWWWWWWWWWWWW....................1...............BBWWWwwWWBB...........................................................WW..wwWWBWWWWWW........................................................................................................................................................WWWWBBWWWWW............................................................................................................................................................................................................................................WWWWWWWWWWW............................................................................................................
WWWWWWWWWWWWW.!.P...............BBB.............BBWWWWWwwwWBB..............BBB........................1BBB.................WwwwBWWWWWW........................................................................................................................................................WWWBWWBWWWW............................................................................................................................................................................................................................................WWWBWWWBWWW............................................................................................................
WWWWWWWWWWWWWWWPP..............BBBBB...........BBWWWWWWAwwWWBB....WW......BBBBB.......................BBBBB................WWwwWBBWWWW........................................................................................................................................................WWWBWWBWWWW............................................................................................................................................................................................................................................WWWBBWBBWWW............................................................................................................
WWWWWWWWWWWWWWWW..............BBWWWBB.........BBWWWWWwwwwWWWWBB..........BBWWWBB...............WW....bBWWWBB...............WWwwWWWBWWW........................................................................................................................................................WWWBBBWWWWW............................................................................................................................................................................................................................................WWWBWBWBWWW............................................................................................................
WWWWWWWWWWWWWWW..............BBWW.WWBB..........WwwwwwwWWWWWW...........BBWW.WWBB...................BbwW.WWBB..............WwwWWWWBWWW........................................................................................................................................................WWWBWWBWWWW............................................................................................................................................................................................................................................WWWBWWWBWWW............................................................................................................
WWWWWWWWWWWWWWW.............BBWWWWWWWBB.........WWwwAWWWWWWWW..........BBWWWWWWWBB.........WW......BBWwwwWWWBB.............wwWWWBBWWWW........................................................................................................................................................WWWBWWWBWWW............................................................................................................................................................................................................................................WWWBWWWBWWW............................................................................................................
WWWWWWWWWWWWWWW...............WWWWWWW...........WWwwwWWWWWWWW............WWWWWWW.....WWW.............WWwAWWW...............WWWWWWWWWWW...............PPPPPPP...........PPPPPPP..................PPPPPPP.........................PPPPPPP...........PPPPPPP...............PPPPPPP...............WWWWWWWWWWW...............PPPPPPP...........PPPPPPP..................PPPPPPP.....................PPPPPPP...........PPPPPPP..................PPPPPPP.....................PPPPPPP.....................PPPPPPP..................PPPPPPP...................WWWWWWWWWWW............................................................................................................
WWWWWWWWWWWWWWW.......PPP.....WWW.WWW...........PppPPP.PPPPPP............WWW.WWW.....................WWw.WWW.............WWWWWWWWWWWWW...............WWW.WWW...........WWW.WWW..................WWW.WWW.........................WWW.WWW...........WWW.WWW...............WWW.WWW...............WWWWWWWWWWW...............WWW.WWW...........WWW.WWW..................WWW.WWW.....................WWW.WWW...........WWW.WWW..................WWW.WWW.....................WWW.WWW.....................WWW.WWW..................WWW.WWW...................WWWWWWWWWWW............................................................................................................
WWWWWWWWWWWWWWW.....PPPPPP....PPP.PPP...........ppPPPP.PPPPPP............PPP.PPP.....................PPP.ppp.........1.....WWWWWWWWWWW...............PPP.PPP...........PPP.PPP..................PPP.PPP.........................PPP.PPP...........PPP.PPP...............PPP.PPP...............WWWWWWWWWWW...............PPP.PPP...........PPP.PPP..................PPP.PPP.....................PPP.PPP...........PPP.PPP..................PPP.PPP.....................PPP.PPP.....................PPP.PPP..................PPP.PPP...................WWWWWWWWWWW............................................................................................................
GGGGGGGGGGGGGGGGGGGGGGGGGGGGGGGGGGGGGGGGGGGGGGGGGGGGGGGGGGGGGGGGGGGGGGGGGGGGGGGGGGGGGGGGGGGGGGGGGGGGGGGGGGGGGGGGGGGGGGGGGGGGGGGGGGGGGGGGGGGGGGGGGGGGGGGGGGGGGGGGGGGGGGGGGGGGGGGGGGGGGGGGGGGGGGGGGGGGGGGGGGGGGGGGGGGGGGGGGGGGGGGGGGGGGGGGGGGGGGGGGGGGGGGGGGGGGGGGGGGGGGGGGGGGGGGGGGGGGGGGGGGGGGGGGGGGGGGGGGGGGGGGGGGGGGGGGGGGGGGGGGGGGGGGGGGGGGGGGGGGGGGGGGGGGGGGGGGGGGGGGGGGGGGGGGGGGGGGGGGGGGGGGGGGGGGGGGGGGGGGGGGGGGGGGGGGGGGGGGGGGGGGGGGGGGGGGGGGGGGGGGGGGGGGGGGGGGGGGGGGGGGGGGGGGGGGGGGGGGGGGGGGGGGGGGGGGGGGGGGGGGGGGGGGGGGGGGGGGGGGGGGGGGGGGGGGGGGGGGGGGGGGGGGGGGGGGGGGGGGGGGGGGGGGGGGGGGGGGGGGGGGGGGGGGGGGGGGGGGGGGGGGGGGGGGGGGGGGGGGGGGGGGGGGGGGGGGGGGGGGGGGGGGGGGGGG
GGGGGGGGGGGGGGGGGGGGGGGGGGGGGGGGGGGGGGGGGGGGGGGGGGGGGGGGGGGGGGGGGGGGGGGGGGGGGGGGGGGGGGGGGGGGGGGGGGGGGGGGGGGGGGGGGGGGGGGGGGGGGGGGGGGGGGGGGGGGGGGGGGGGGGGGGGGGGGGGGGGGGGGGGGGGGGGGGGGGGGGGGGGGGGGGGGGGGGGGGGGGGGGGGGGGGGGGGGGGGGGGGGGGGGGGGGGGGGGGGGGGGGGGGGGGGGGGGGGGGGGGGGGGGGGGGGGGGGGGGGGGGGGGGGGGGGGGGGGGGGGGGGGGGGGGGGGGGGGGGGGGGGGGGGGGGGGGGGGGGGGGGGGGGGGGGGGGGGGGGGGGGGGGGGGGGGGGGGGGGGGGGGGGGGGGGGGGGGGGGGGGGGGGGGGGGGGGGGGGGGGGGGGGGGGGGGGGGGGGGGGGGGGGGGGGGGGGGGGGGGGGGGGGGGGGGGGGGGGGGGGGGGGGGGGGGGGGGGGGGGGGGGGGGGGGGGGGGGGGGGGGGGGGGGGGGGGGGGGGGGGGGGGGGGGGGGGGGGGGGGGGGGGGGGGGGGGGGGGGGGGGGGGGGGGGGGGGGGGGGGGGGGGGGGGGGGGGGGGGGGGGGGGGGGGGGGGGGGGGGGGGGGGGGGGG