WWWWWWWWWWWWWWW.................................................................................................................................................................................................................................................................................................................WWWWWWWWWWW
WWWWWWWWWWWWWWW.................................................................................................................................................................................................................................................................................................................WWWWWWWWWWW
WWWWWWWWWWWWWWW.................................................................................................................................................................................................................................................................................................................WWWWWWWWWWW
WWWWWWWWWWWWWWW.................................................................................................................................................................................................................................................................................................................WWWWWWWWWWW
WWWWWWWWWWWWWWW.................................................................................................................................................................................................................................................................................................................WWWWWWWWWWW
WWWWWWWWWWWWWWW..............................................................................W..................................................................................................................................................................................................................................WWWWWWWWWWW
WWWWWWWWWWWWWWW..................................................................................WWWW...........................................................................................................................................................................................................................WWWWWWWWWWW
WWWWWWWWWWWWWWW...........................................................................W.....................................................................................................................................................................................................................................WWWWWWWWWWW
WWWWWWWWWWWWWWW.................................................................................................................................................................................................................................................................................................................WWWWWWWWWWW
WWWWWWWWWWWWWWW..............................................................................WW..........WWWW...................................................................................................................................................................................................................WWWWWWWWWWW
WWWWWWWWWWWWWWW.................................................................................................................................................................................................................................................................................................................WWWWWWWWWWW
WWWWWWWWWWWWWWW..................................................................................WWW............................................................................................................................................................................................................................WWWWWWWWWWW
WWWWWWWWWWWWWWW........................................................................................W........................................................................................................................................................................................................................WWWWWWWWWWW
WWWWWWWWWWWWWWW...............................................................................................WWWW..............................................................................................................................................................................................................WWWWWWWWWWW
WWWWWWWWWWWWWWW....................................................................................WW...........................................................................................................................................................................................................................WWWWWWWWWWW
WWWWWWWWWWWWWWW.........................................................................WWWW...W................................................................................................................................................................................................................................WWWWWWWWWWW
WWWWWWWWWWWWWWW.....................................................w.W.W.w.w.w.W.W.W...........................................................................................................................................................................................................................................WWWWWWWWWWW
WWWWWWWWWWWWWWW.....................................................WwwWWWwwwwwwWWWWW...........................................................................................................................................................................................................................................WWWWWWWWWWW
WWWWWWWWWWWWWWW..................................WWW............WW...WwW.........WWW.WW.........................................................................................................................................................................................................................................WWWWWWWWWWW
WWWWWWWWWWWWWWW.......................................W..............WwW.....E.....W............................................................................................................................................................................................................................................WWWWWWWWWWW
WWWWWWWWWWWWWWW..............................WW............WWW.......W...E.WWWWWWW.W.....WA.....................................................................................................................................................................................................................................WWWWWWWWWWW
WWWWWWWWWWWWWWW.......................................EW.............WWWWWW......wwW............................................................................................................................................................................................................................................WWWWWWWWWWW
WWWWWWWWWWWWWWW..................................WW..................WWWWW..WWAWWWww.....WWW....................................................................................................................................................................................................................................WWWWWWWWWWW
WWWWWWWWWWWWWWW......................................WWW........W....WWWWWW.......wWWW..........................................................................................................................................................................................................................................WWWWWWWWWWW
WWWWWWWWWWWWWWW............................................WW........w.....WWWWWWWWW............................................................................................................................................................................................................................................WWWWWWWWWWW
WWWWWWWWWWWWWWW....................................................WWWW...........WW............................................................................................................................................................................................................................................WWWWWWWWWWW
WWWWWWWWWWWWWWW......................................................W....WWWAWWWAWW............................................................................................................................................................................................................................................WWWWWWWWWWW
WWWWWWWWWWWWWWW......................................................WWW...........W............................................................................................................................................................................................................................................WWWWWWWWWWW
WWWWWWWWWWWWWWW......................................................W..E..........w............................................................................................................................................................................................................................................WWWWWWWWWWW
WWWWWWWWWWWWWWW......................................................WWWWWWWWWWWWWWWWWW.........WWAW............................................................................................................................................................................................................................WWWWWWWWWWW
WWWWWWWWWWWWWWW......................................................WWWWWWWWWWWWWWW......WW....................................................................................................................................................................................................................................WWWWWWWWWWW
WWWWWWWWWWWWWWW......................................................WWWWWWWWWWWWWWW....W......WWWWWW...........................................................................................................................................................................................................................WWWWWWWWWWW
WWWWWWWWWWWWWWW......................................................WWWWWWWCCWWWWWW..W.................WW......................................................................................................................................................................................................................WWWWWWWWWWW
WWWWWWWWWWWWWWW......................................................WWWWWWWECwwwwww............................................................................................................................................................................................................................................WWWWWWWWWWW
WWWWWWWWWWWWWWW.................................E.....WWWW..........GGGGGGGGGGGGGGGGGGG.....................WWWW................................................................................................................................................................................................................WWWWWWWWWWW
WWWWWWWWWWWWWWW.............................WWWWWWW...........WW...AGGG......GGGGGGGGGG.................WA......................................................................................................................................................................................................................WWWWWWWWWWW
WWWWWWWWWWWWWWW........................AW...............................GGGG...GGGGGGG..........................................................................................................................................................................................................................................WWWWWWWWWWW
WWWWWWWWWWWWWWW...............WWWW...............................GGGGGGGGG.GGG....GGGG.................WWWW.....................................................................................................................................................................................................................WWWWWWWWWWW
WWWWWWWWWWWWWWW.......................WWWWW.......................GGGGGG..GGGGGGG.G...AWW........WWW............................................................................................................................................................................................................................WWWWWWWWWWW
WWWWWWWWWWWWWWW.......WAWWWW......................................G.GGGG.GG.GG.GG.......WW......................................................................................................................................................................................................................................WWWWWWWWWWW
WWWWWWWWWWWWWWW.WWW...............................................GG.G....GG.....GGGWW.......WW.................................................................................................................................................................................................................................WWWWWWWWWWW
WWWWWWWWWWWWWWW....................................................GG....GG......GG....WWWW.....................................................................................................................................................................................................................................WWWWWWWWWWW
WWWWWWWWWWWWWWW....WWWAW............................................GG....GG....GG..............................................................................................................................................................................................................................................WWWWWWWWWWW
WWWWWWWWWWW.P......................................................GG...........................................................................................................................................................................................................................................................WWWWWWWWWWW
GGGWWGWWGGGWWWWWWW....G..........................................................................................................................................................................................................................................................................................................WWWWWWWWWW
GGGGWGGGGGWWW......GG.............................................................................................................................................................................................................................................................................................................WWWWWWWWW
GGGGGWGGWGGW.......................................................................................................................................................................................................................................................................................................................WWWWWWWW
GGGGGGGGGWW.........................................................................................................................................................................................................................................................................................................................WWWWWWW