WWWWWWWWWWW.................................................................................................................................................................................................................................................................................................................WWWWWWWWWWW
WWWWWWWWWWW.................................................................................................................................................................................................................................................................................................................WWWWWWWWWWW
WWWWWWWWWWW.....................................................W.W.W.W.W.W.W.W.W...........................................................................................................................................................................................................................................WWWWWWWWWWW
WWWWWWWWWWW.....................................................WWWWWWWWWWWWWWWWW...........................................................................................................................................................................................................................................WWWWWWWWWWW
WWWWWWWWWWW......................................................WWWWWWWWWWWWWWW............................................................................................................................................................................................................................................WWWWWWWWWWW
WWWWWWWWWWW......................................................WWWWWWWWWWWWWWW............................................................................................................................................................................................................................................WWWWWWWWWWW
WWWWWWWWWWW......................................................WWWWWWW..WWWWWW............................................................................................................................................................................................................................................WWWWWWWWWWW
WWWWWWWWWWW......................................................WWWWWWW..WWWWWW............................................................................................................................................................................................................................................WWWWWWWWWWW
WWWWWWWWWWW.......................................WWWW..........GGGGGGGGGGGGGGGGGGG.........................................................................................................................................................................................................................................WWWWWWWWWWW
WWWWWWWWWWW.............................WWWWWWW...........WW...AGGG......GGGGGGGGGG.........................................................................................................................................................................................................................................WWWWWWWWWWW
WWWWWWWWWWW........................AW...............................GGGG...GGGGGGG..........................................................................................................................................................................................................................................WWWWWWWWWWW
WWWWWWWWWWW...............WWWW...............................GGGGGGGGG.GGG....GGGG......WW..................................................................................................................................................................................................................................WWWWWWWWWWW
WWWWWWWWWWW.......................WWWWW.......................GGGGGG..GGGGGGG.G...AWWW.......WWW............................................................................................................................................................................................................................WWWWWWWWWWW
WWWWWWWWWWW.......WAWWWW......................................G.GGGG.GG.GG.GG...............................................................................................................................................................................................................................................WWWWWWWWWWW
WWWWWWWWWWW.WWW...............................................GG.G....GG.....GGGWW.......WW........WWWAW....................................................................................................................................................................................................................WWWWWWWWWWW
WWWWWWWWWWW.P..................................................GG....GG......GG....WWWW.....................................................................................................................................................................................................................................WWWWWWWWWWW
WWWWWWWWWWW....WWWAW............................................GG....GG....GG...............WWWW....WW...WWWW..............................................................................................................................................................................................................WWWWWWWWWWW
WWWWWWWWWWW....................................................GG...........................................................................................................................................................................................................................................................WWWWWWWWWWW
WWWWWWWWWWGGGGGGGGGGGGGGGGGGGGGG...................................................................WWWW.................GGG..WWGGGGGGGGGGGGGGGGGGGGGGGGGGGGGGGGGGGGGGGGGGGGGGGGGGGGGGGGGGGGGGGGGGGGGGGGGGGGGGGGGGGGGGGGGGGGGGGGGGGGGGGGGGGGGGGGGGGGGGGGGGGGGGGGGGGGGGGGGGGGGGGGGGGGGGGGGGGGGGGGGGGGGGGGGGGGGGGGGGGGGGGGGGGGGGWWWWWWWWWW
WWWWWWWWWGGGGGGGGGGGGGGGGGGGGGGG................................................................................WWW.........WWGGGGGGGGGGGGGGGGGGGGGGGGGGGGGGGGGGGGGGGGGGGGGGGGGGGGGGGGGGGGGGGGGGGGGGGGGGGGGGGGGGGGGGGGGGGGGGGGGGGGGGGGGGGGGGGGGGGGGGGGGGGGGGGGGGGGGGGGGGGGGGGGGGGGGGGGGGGGGGGGGGGGGGGGGGGGGGGGGGGGGGGGGGGGGGGGWWWWWWWWW
WWWWWWWWGGGGGGGGGGGGGGGGGGGGGGGG..........................................................................WWW.........WWWWWWWGGGGGGGGGGGGGGGGGGGGGGGGGGGGGGGGGGGGGGGGGGGGGGGGGGGGGGGGGGGGGGGGGGGGGGGGGGGGGGGGGGGGGGGGGGGGGGGGGGGGGGGGGGGGGGGGGGGGGGGGGGGGGGGGGGGGGGGGGGGGGGGGGGGGGGGGGGGGGGGGGGGGGGGGGGGGGGGGGGGGGGGGGGGGGGGGGGWWWWWWWW
WWWWWWWGGGGGGGGGGGGGGGGGGGGGGGGG........................................................................................GGGGGGGGGGGGGGGGGGGGGGGGGGGGGGGGGGGGGGGGGGGGGGGGGGGGGGGGGGGGGGGGGGGGGGGGGGGGGGGGGGGGGGGGGGGGGGGGGGGGGGGGGGGGGGGGGGGGGGGGGGGGGGGGGGGGGGGGGGGGGGGGGGGGGGGGGGGGGGGGGGGGGGGGGGGGGGGGGGGGGGGGGGGGGGGGGGGGGGGGWWWWWWW