WWWWWWWWWW.....................................................................................WWWWWWWWWW
WWWWWWWWWW.....................................................................................WWWWWWWWWW
WWWWWWWWWW.....................................................................................WWWWWWWWWW
WWWWWWWWWW.....................................................................................WWWWWWWWWW
WWWWWWWWWW.....................................................................................WWWWWWWWWW
WWWWWWWWWW.....................................................................................WWWWWWWWWW
WWWWWWWWWW.....................................................................................WWWWWWWWWW
WWWWWWWWWW......................................A..............................................WWWWWWWWWW
WWWWWWWWWW.................................................................................I...WWWWWWWWWW
WWWWWWWWWW....WWWWWW.........................WWWWWW...WWW.........................WWW......I...WWWWWWWWWW
WWWWWWWWWW............................WWWW............WWW........................WWWW......I...WWWWWWWWWW
WWWWWWWWWW.............AW..WW.........................WWW.......................WWWWW......I...WWWWWWWWWW
WWWWWWWWWW.......................WWW..................WWW......................WWWWWW......I...WWWWWWWWWW
WWWWWWWWWW.P.......WAWW...............................WWW.....................WWWWWWW......I...WWWWWWWWWW
WWWWWWWWWW........E...........E.......................WW.....................WWWWWWWW......I...WWWWWWWWWW
GGGGGGGGGGGGGGGGGGGGG...GGGGGGGGGGGGGGGGGGGG....GGGGGGG..GGGGGGGGGGGGGGGGGGGGGGGGGGGGGGGGGGFGGGGGGGGGGGGG
GGGGGGGGGGGGGGGGGGGGG....GGGGGGGGGGGGGGGGGG......GGGGG..GGGGGGGGGGGGGGGGGGGGGGGGGGGGGGGGGGGGGGGGGGGGGGGGG
GGGGGGGGGGGGGGGGGGGGG..................................GGGGGGGGGGGGGGGGGGGGGGGGGGGGGGGGGGGGGGGGGGGGGGGGGG
GGGGGGGGGGGGGGGGGGGGG...GGGGGGGGGGGGGGGGGGGG....GGGGGGGGGGGGGGGGGGGGGGGGGGGGGGGGGGGGGGGGGGGGGGGGGGGGGGGGG