XXXXXX.................................................................................I...XXXXXX
XXXXXX.....XXX............................XXXX....XXX.........................XXX......I...XXXXXX
XXXXXX............................XXXX............XXX........................XXXX......I...XXXXXX
XXXXXX.............XX..XX.........................XXX.......................XXXXX......I...XXXXXX
XXXXXX.......................XXX..................XXX......................XXXXXX......I...XXXXXX
XXXXXX.........XXXX...............................XXX.....................XXXXXXX......I...XXXXXX
XXXXXX............................................XXX....................XXXXXXXX......I...XXXXXX
XXXXXXXXXXXXXXXXX...XXXXXXXXXXXXXXXXXXXX....XXXXXXXXXXXXXXXXXXXXXXXXXXXXXXXXXXXXXXXXXXXXXXXXXXXXX
XXXXXXXXXXXXXXXXX...XXXXXXXXXXXXXXXXXXXX....XXXXXXXXXXXXXXXXXXXXXXXXXXXXXXXXXXXXXXXXXXXXXXXXXXXXX