WWWWWWWWWWWWWWW............................................................................................................WWWWWWWWWWW........................................................................................................................................................WWWWWWWWWWW............................................................................................................................................................................................................................................WWWWWWWWWWW............................................................................................................
WWWWWWWWWWWWWWW............................................................................................................WWWWWWWWWWW........................................................................................................................................................WWWWWWWWWWW............................................................................................................................................................................................................................................WWWWWWWWWWW............................................................................................................
WWWWWWWWWWWWWWW............................................................................................................WWWWWWWWWWW........................................................................................................................................................WWWWWWWWWWW............................................................................................................................................................................................................................................WWWWWWWWWWW............................................................................................................
WWWWWWWWWWWWWWW............................................................................................................WWWWWWWWWWW........................................................................................................................................................WWWWWWWWWWW............................................................................................................................................................................................................................................WWWWWWWWWWW............................................................................................................
WWWWWWWWWWWWWWW............................................................................................................WWWWWWWWWWW........................................................................................................................................................WWWWWWWWWWW............................................................................................................................................................................................................................................WWWWWWWWWWW............................................................................................................
WWWWWWWWWWWWWWW............................................................................................................WWWWWWWWWWW........................................................................................................................................................WWWWWWWWWWW............................................................................................................................................................................................................................................WWWWWWWWWWW............................................................................................................
WWWWWWWWWWWWWWW............................................................................................................WWWWWWWWWWW........................................................................................................................................................WWWWWWWWWWW............................................................................................................................................................................................................................................WWWWWWWWWWW............................................................................................................
WWWWWWWWWWWWWWW............................................................................................................WWWWWWWWWWW........................................................................................................................................................WWWWWWWWWWW............................................................................................................................................................................................................................................WWWWWWWWWWW............................................................................................................
WWWWWWWWWWWWWWW............................................................................................................WWWWWWWWWWW........................................................................................................................................................WWWWWWWWWWW............................................................................................................................................................................................................................................WWWWWWWWWWW............................................................................................................
WWWWWWWWWWWWWWW............................................................................................................WWWWWWWWWWW........................................................................................................................................................WWWWWWWWWWW............................................................................................................................................................................................................................................WWWWWWWWWWW............................................................................................................
WWWWWWWWWWWWWWW............................................................................................................WWWWWWWWWWW........................................................................................................................................................WWWWWWWWWWW............................................................................................................................................................................................................................................WWWWWWWWWWW............................................................................................................
WWWWWWWWWWWWWWW............................................................................................................WWWWWWWWWWW........................................................................................................................................................WWWWWWWWWWW............................................................................................................................................................................................................................................WWWWWWWWWWW............................................................................................................
WWWWWWWWWWWWWWW............................................................................................................WWWWWWWWWWW........................................................................................................................................................WWWWWWWWWWW............................................................................................................................................................................................................................................WWWWWWWWWWW............................................................................................................
WWWWWWWWWWWWWWW............................................................................................................WWWWWWWWWWW........................................................................................................................................................WWWWWWWWWWW............................................................................................................................................................................................................................................WWWWWWWWWWW............................................................................................................
WWWWWWWWWWWWWWW............................................................................................................WWWWWWWWWWW........................................................................................................................................................WWWWWWWWWWW............................................................................................................................................................................................................................................WWWWWWWWWWW............................................................................................................
WWWWWWWWWWWWWWW............................................................................................................WWWWWWWWWWW........................................................................................................................................................WWWWWWWWWWW............................................................................................................................................................................................................................................WWWWWWWWWWW............................................................................................................
WWWWWWWWWWWWWWW............................................................................................................WWWWWWWWWWW........................................................................................................................................................WWWWWWWWWWW............................................................................................................................................................................................................................................WWWWWWWWWWW............................................................................................................
WWWWWWWWWWWWWWW............................................................................................................WWWWWWWWWWW........................................................................................................................................................WWWWWWWWWWW............................................................................................................................................................................................................................................WWWWWWWWWWW............................................................................................................
WWWWWWWWWWWWWWW............................................................................................................WWWWWWWWWWW........................................................................................................................................................WWWWWWWWWWW............................................................................................................................................................................................................................................WWWWWWWWWWW............................................................................................................
WWWWWWWWWWWWWWBB...........................................................................................................WWWWWWWWWWW........................................................................................................................................................WWWWWWWWWWW............................................................................................................................................................................................................................................WWWWWWWWWWW............................................................................................................
WWWWWWWWWWWWWWPPBB.........................................................................................................WWWWWWWWWWW........................................................................................................................................................WWWWWWWWWWW............................................................................................................................................................................................................................................WWWWWWWWWWW............................................................................................................
WWWWWWWWWWWWW..............................................................................................................WWWWWWWWWWW........................................................................................................................................................WWWWWWWWWWW............................................................................................................................................................................................................................................WWWWWWWWWWW............................................................................................................
WWWWWWWWWWWWW.!.P...............BBB........................................................................................WWWWWwwWWWW........................................................................................................................................................WWWWWWWWWWW............................................................................................................................................................................................................................................WWWWWWWWWWW............................................................................................................
WWWWWWWWWWWWWWWPP..............BBBBB.......................................................................................WWWWwWWWWWW........................................................................................................................................................WWWWwwWWWWW............................................................................................................................................................................................................................................WWWWWWWWWWW............................................................................................................
WWWWWWWWWWWWWWWW..............BBWWWBB......................................................................................WWWWwWWWWWW........................................................................................................................................................WWWwWWwWWWW............................................................................................................................................................................................................................................WWWwWWWwWWW............................................................................................................
WWWWWWWWWWWWWWW..............BBWW.WWBB.....................................................................................WWWWWwwWWWW........................................................................................................................................................WWWwWWwWWWW............................................................................................................................................................................................................................................WWWwwWwwWWW............................................................................................................
WWWWWWWWWWWWWWW.............BBWWWWWWWBB....................................................................................WWWWWWWwWWW........................................................................................................................................................WWWwwwWWWWW............................................................................................................................................................................................................................................WWWwWwWwWWW............................................................................................................
WWWWWWWWWWWWWWW...............WWWWWWW...........PPPPPPP..................PPPPPPP.....................PPPPPPP...............WWWWWWWwWWW...............PPPPPPP...........PPPPPPP..................PPPPPPP.........................PPPPPPP...........PPPPPPP...............PPPPPPP...............WWWwWWwWWWW...............PPPPPPP...........PPPPPPP..................PPPPPPP.....................PPPPPPP...........PPPPPPP..................PPPPPPP.....................PPPPPPP.....................PPPPPPP..................PPPPPPP...................WWWwWWWwWWW............................................................................................................
WWWWWWWWWWWWWWW...............WWW.WWW...........WWW.WWW..................WWW.WWW.....................WWW.WWW...............WWWWWwwWWWW...............WWW.WWW...........WWW.WWW..................WWW.WWW.........................WWW.WWW...........WWW.WWW...............WWW.WWW...............WWWwWWWwWWW...............WWW.WWW...........WWW.WWW..................WWW.WWW.....................WWW.WWW...........WWW.WWW..................WWW.WWW.....................WWW.WWW.....................WWW.WWW..................WWW.WWW...................WWWwWWWwWWW............................................................................................................
WWWWWWWWWWWWWWW...............PPP.PPP...........PPP.PPP..................PPP.PPP.....................PPP.PPP...............WWWWWWWWWWW...............PPP.PPP...........PPP.PPP..................PPP.PPP.........................PPP.PPP...........PPP.PPP...............PPP.PPP...............WWWWWWWWWWW...............PPP.PPP...........PPP.PPP..................PPP.PPP.....................PPP.PPP...........PPP.PPP..................PPP.PPP.....................PPP.PPP.....................PPP.PPP..................PPP.PPP...................WWWWWWWWWWW............................................................................................................
GGGGGGGGGGGGGGGGGGGGGGGGGGGGGGGGGGGGGGGGGGGGGGGGGGGGGGGGGGGGGGGGGGGGGGGGGGGGGGGGGGGGGGGGGGGGGGGGGGGGGGGGGGGGGGGGGGGGGGGGGGGGGGGGGGGGGGGGGGGGGGGGGGGGGGGGGGGGGGGGGGGGGGGGGGGGGGGGGGGGGGGGGGGGGGGGGGGGGGGGGGGGGGGGGGGGGGGGGGGGGGGGGGGGGGGGGGGGGGGGGGGGGGGGGGGGGGGGGGGGGGGGGGGGGGGGGGGGGGGGGGGGGGGGGGGGGGGGGGGGGGGGGGGGGGGGGGGGGGGGGGGGGGGGGGGGGGGGGGGGGGGGGGGGGGGGGGGGGGGGGGGGGGGGGGGGGGGGGGGGGGGGGGGGGGGGGGGGGGGGGGGGGGGGGGGGGGGGGGGGGGGGGGGGGGGGGGGGGGGGGGGGGGGGGGGGGGGGGGGGGGGGGGGGGGGGGGGGGGGGGGGGGGGGGGGGGGGGGGGGGGGGGGGGGGGGGGGGGGGGGGGGGGGGGGGGGGGGGGGGGGGGGGGGGGGGGGGGGGGGGGGGGGGGGGGGGGGGGGGGGGGGGGGGGGGGGGGGGGGGGGGGGGGGGGGGGGGGGGGGGGGGGGGGGGGGGGGGGGGGGGGGGGGGGGGG
GGGGGGGGGGGGGGGGGGGGGGGGGGGGGGGGGGGGGGGGGGGGGGGGGGGGGGGGGGGGGGGGGGGGGGGGGGGGGGGGGGGGGGGGGGGGGGGGGGGGGGGGGGGGGGGGGGGGGGGGGGGGGGGGGGGGGGGGGGGGGGGGGGGGGGGGGGGGGGGGGGGGGGGGGGGGGGGGGGGGGGGGGGGGGGGGGGGGGGGGGGGGGGGGGGGGGGGGGGGGGGGGGGGGGGGGGGGGGGGGGGGGGGGGGGGGGGGGGGGGGGGGGGGGGGGGGGGGGGGGGGGGGGGGGGGGGGGGGGGGGGGGGGGGGGGGGGGGGGGGGGGGGGGGGGGGGGGGGGGGGGGGGGGGGGGGGGGGGGGGGGGGGGGGGGGGGGGGGGGGGGGGGGGGGGGGGGGGGGGGGGGGGGGGGGGGGGGGGGGGGGGGGGGGGGGGGGGGGGGGGGGGGGGGGGGGGGGGGGGGGGGGGGGGGGGGGGGGGGGGGGGGGGGGGGGGGGGGGGGGGGGGGGGGGGGGGGGGGGGGGGGGGGGGGGGGGGGGGGGGGGGGGGGGGGGGGGGGGGGGGGGGGGGGGGGGGGGGGGGGGGGGGGGGGGGGGGGGGGGGGGGGGGGGGGGGGGGGGGGGGGGGGGGGGGGGGGGGGGGGGGGGGGGGGGGG