WWWWWWWWWWWWWWW.............................................................................................................................................................................................................................................................................................................................................................................................................................................................................................................................................................................................................................................................
WWWWWWWWWWWWWWW.............................................................................................................................................................................................................................................................................................................................................................................................................................................................................................................................................................................................................................................................
WWWWWWWWWWWWWWW.............................................................................................................................................................................................................................................................................................................................................................................................................................................................................................................................................................................................................................................................
WWWWWWWWWWWWWWW.............................................................................................................................................................................................................................................................................................................................................................................................................................................................................................................................................................................................................................................................
WWWWWWWWWWWWWWW...............................................................................................................1...1.........................................................................................................................................................................................................................................................................................................................................................................................................................................................................................................................................
WWWWWWWWWWWWWWW....................................................................................................1...WW..WWWWWWWWWWW........................................................................................................................................................WWWAWWWwwWW............................................................................................................................................................................................................................................WWWWWWWWWWW............................................................................................................
WWWWWWWWWWWWWWW..................................................................................................WWW.......WWWWWWWWWWW........................................................................................................................................................WW.......WW............................................................................................................................................................................................................................................WWWWWWWWWWW............................................................................................................
WWWWWWWWWWWWWWW.............................................................................................WW.............WWWWWWWWWWW........................................................................................................................................................WWWW....WWW............................................................................................................................................................................................................................................WWWWWWWWWWW............................................................................................................
WWWWWWWWWWWWWWW............................................................................................................WWWWWWWWWWW........................................................................................................................................................ww.......WW............................................................................................................................................................................................................................................WWWWWWWWWWW............................................................................................................
WWWWWWWWWWWWWWW...........................................................................................WW..WA...........WWWWWWWWWWW.......................................................................................................................................................WWWWWWWWWWWW............................................................................................................................................................................................................................................WWWWWWWWWWW............................................................................................................
WWWWWWWWWWWWWWW............................................................................................................WWWWWWWWWWW..................................................................................................................................................WW....WWWWWWWWWWW............................................................................................................................................................................................................................................WWWWWWWWWWW............................................................................................................
WWWWWWWWWWWWWWW..............................................................................................WWWW..........WWWWWWWWWWW........................................................................................................................................................WWWWWWWWWWW............................................................................................................................................................................................................................................WWWWWWWWWWW............................................................................................................
WWWWWWWWWWWWWWW.....................................................................................................WA.....WWWWWWWWWWW......................................................................................................................................................WWWWWWWWWWWWW............................................................................................................................................................................................................................................WWWWWWWWWWW............................................................................................................
WWWWWWWWWWWWWWW............................................................................................................WWWWWWWWWWW................................................................................................................................WAWW....................WWWWWWWWWWW............................................................................................................................................................................................................................................WWWWWWWWWWW............................................................................................................
WWWWWWWWWWWWWWW......................................................................................................WW....WWWWWWWWWWW.................................................................................................................................................WWW....ww.......WW............................................................................................................................................................................................................................................WWWWWWWWWWW............................................................................................................
WWWWWWWWWWWWWWW............................................................................................................wwwwwwwwWWW...............................................................................................................................WWW......1............WWWWWWWW....WW............................................................................................................................................................................................................................................WWWWWWWWWWW............................................................................................................
WWWWWWWWWWWWWWW..........................................................................................................WWWWWWWAwwWWW.....................................................................................................................................WWWW...............WW......AWW............................................................................................................................................................................................................................................WWWWWWWWWWW............................................................................................................
WWWWWWWWWWWWWWW............................................................................................................WWWwwwwwWWW..........................................................................................................................WWW.................1.........WW......1WW............................................................................................................................................................................................................................................WWWWWWWWWWW............................................................................................................
WWWWWWWWWWWWWWW............................................................................................................WWWwwwwWWWW..................................................................................................................BBBBB.....................WWWW......WAWW....WWWWW............................................................................................................................................................................................................................................WWWWWWWWWWW............................................................................................................
WWWWWWWWWWWWWWW............................................................................................................WWWww1WWWWW.................................................................................................................BBWWWBB................................WW.......WW............................................................................................................................................................................................................................................WWWWWWWWWWW............................................................................................................
WWWWWWWWWWWWWWW............................................................................................................WWwwAWWWWWW........................................WW......................................................................BBWWWWWBB...........................WWWWWW..WA...WW............................................................................................................................................................................................................................................WWWWWWWWWWW............................................................................................................
WWWWWWWWWWWWWWW.............................................................................................................wwwwWWWWWW..............................WW...............................................................................BB.......BB..............................WW.......WW............................................................................................................................................................................................................................................WWWWWWWWWWW............................................................................................................
WWWWWWWWWWWWWWW.........................................................................................................WWWWWWWWWWWWWW...................................WWW.......WWW..............................................................BB...WAW...BB.......................WW....WWWAWW...WW............................................................................................................................................................................................................................................WWWWWWWWWWW............................................................................................................
WWWWWWWWWWWWWBBB...................................BBbbBBB.........................................................WW......WWWWWWWWWWW........................WAWW.................................................................................bb...........BB............................WW1......WW............................................................................................................................................................................................................................................WWWWWWWWWWW............................................................................................................
WWWWWWWWWWWWWWPPBB................................BBWWwWWBB................................................................wWWWWBBWWWW....................................................WWW...............................................WWW...BB...WAWAWAW...BB.................WW........WWWWWWWWwWW............................................................................................................................................................................................................................................WWWWWWWWWWW............................................................................................................
WWWWWWWWWWWWW....................1...............BBWWWwwWWBB...........................................................WW..wwWWBWWWWWW.......................WWWW........................................1...1..........................WW........BB........1......BB..........................WWWwbbwwwWW...........................................................................................................................................................................................................................................WWWWWWWWWWW............................................................................................................
WWWWWWWWWWWWW.!.P...............BBB.............BBWWWWWwwwWBB..............BBB........................1BBB.................WwwwBWWWWWW.................BBB...............BBB......................BbBBBBBBBBBBBBBBBB...WWW......................BBWWWWWWWWWWWW..WWWBB...........BBB...........WWWbwwbwWWW............................................................................................................................................................................................................................................WWWBWWWBWWW............................................................................................................
WWWWWWWWWWWWWWPPP..............BBBBB...........BBWWWWWWAwwWWBB....WW......BBBBB.......................BBBBB................WWwwWBBWWWW................BBBBB.............BBBBB....................BB................BB.............BBB.............WWWWWWWWWWW..WWWW............BBBBB..........WWWbwwbwWWW............................................................................................................................................................................................................................................WWWBBWBBWWW............................................................................................................
WWWWWWWWWWWWWWWW..............BBWWWBB.........BBWWWWWwwwwWWWWBB..........BBWWWBB...............WW....bBWWWBB...............WWwwWWWBWWW...............bbwWWBB...........BBWWWBB..................BBWP...WAWW..WAWA...BB...........BBBBB............WW.1........WWWWW...........BBW.WBB.........WWwbBBWWWWW............................................................................................................................................................................................................................................WWWBWBWBWWW............................................................................................................
WWWWWWWWWWWWWWW..............BBWW.WWBB..........WwwwwwwWWWWWW...........BBWW.WWBB...........1.......BbwW.WWBB..............WwwWWWWBWWW.......WWW....BBWwwWWBB.........BBWW.WWBB................BBWWPP........1.......BB.........BBWWWBB...........WW.WAWAW...WWWWWW..........BBWWWWWBB........WWwbWWBWWWW............................................................................................................................................................................................................................................WWWBWWWBWWW............................................................................................................
WWWWWWWWWWWWWWW.............BBWWWWWWWBB.........WWwwAWWWWWWWW..........BBWWWWWWWBB.........WW......BBWwwwWWWBB.............wwWWWBBWWWW..WW.........BBWWWwWWWBB.......BBWWWWWWWBB..............BBWWWWWWWWWWWWWWWWWWWWWWBB.......BBWW.WWBB..........WW........WWWWWWW.........BBWWWWWWWBB.......WwwBWWWBWWW............................................................................................................................................................................................................................................WWWBWWWBWWW............................................................................................................
WWWWWWWWWWWWWWW...............WWWWWWW...........WWwwwWWWWWWWW............WWWWWWW.....WWW.............WWwAWWW...............WWWWWWWWWWW...............WWWAWWW...........WWWWWWW..................WWWWWWWWWWWWWWWWWWWWWW........BBWWWWWWWBB.........WWWWWWWWWWWWWWWWW...........WWWWWWW.........wwWWWWWWWWW...............PPPPPPP...........PPPPPPP..................PPPPPPP.....................PPPPPPP...........PPPPPPP..................PPPPPPP.....................PPPPPPP.....................PPPPPPP..................PPPPPPP...................WWWWWWWWWWW............................................................................................................
WWWWWWWWWWWWWWW.......PPP.....WWW.WWW...........PppPPP.PPPPPP............WWW.WWW.....................WWw.WWW.............WWWWWWWWWWWWW....WW.........WWW.WWW...........WWW.WWW..................WWW.WWWWWWWWWWWWWWWWWW..........WWW.WWW...........WWWWWWWW.WWWWWWWW...........WWW.WWW...WWAW..WWWWWWWWWWW...............WWW.WWW...........WWW.WWW..................WWW.WWW.....................WWW.WWW...........WWW.WWW..................WWW.WWW.....................WWW.WWW.....................WWW.WWW..................WWW.WWW...................WWWWWWWWWWW............................................................................................................
WWWWWWWWWWWWWWW.....PPPPPP....PPP.PPP...........ppPPPP.PPPPPP............PPP.PPP.....................PPP.ppp.........1.....WWWWWWWWWWW...............ppp.PPP...........PPP.PPP..................PPP.PPPPPPPPPPPPPPPPPP..........PPP.PPP...........PPPPPPPP.PPPPPPPP...........PPP.PPP.........WWWWWWWWWWW...............PPP.PPP...........PPP.PPP..................PPP.PPP.....................PPP.PPP...........PPP.PPP..................PPP.PPP.....................PPP.PPP.....................PPP.PPP..................PPP.PPP...................WWWWWWWWWWW............................................................................................................
GGGGGGGGGGGGGGGGGGGGGGGGGGGGGGGGGGGGGGGGGGGGGGGGGGGGGGGGGGGGGGGGGGGGGGGGGGGGGGGGGGGGGGGGGGGGGGGGGGGGGGGGGGGGGGGGGGGGGGGGGGGGGGGGGGGGGGGGGGGGGGGGGGGGGGGGGGGGGGGGGGGGGGGGGGGGGGGGGGGGGGGGGGGGGGGGGGGGGGGGGGGGGGGGGGGGGGGGGGGGGGGGGGGGGGGGGGGGGGGGGGGGGGGGGGGGGGGGGGGGGGGGGGGGGGGGGGGGGGGGGGGGGGGGGGGGGGGGGGGGGGGGGGGGGGGGGGGGGGGGGGGGGGGGGGGGGGGGGGGGGGGGGGGGGGGGGGGGGGGGGGGGGGGGGGGGGGGGGGGGGGGGGGGGGGGGGGGGGGGGGGGGGGGGGGGGGGGGGGGGGGGGGGGGGGGGGGGGGGGGGGGGGGGGGGGGGGGGGGGGGGGGGGGGGGGGGGGGGGGGGGGGGGGGGGGGGGGGGGGGGGGGGGGGGGGGGGGGGGGGGGGGGGGGGGGGGGGGGGGGGGGGGGGGGGGGGGGGGGGGGGGGGGGGGGGGGGGGGGGGGGGGGGGGGGGGGGGGGGGGGGGGGGGGGGGGGGGGGGGGGGGGGGGGGGGGGGGGGGGGGGGGGGGGGGGG
GGGGGGGGGGGGGGGGGGGGGGGGGGGGGGGGGGGGGGGGGGGGGGGGGGGGGGGGGGGGGGGGGGGGGGGGGGGGGGGGGGGGGGGGGGGGGGGGGGGGGGGGGGGGGGGGGGGGGGGGGGGGGGGGGGGGGGGGGGGGGGGGGGGGGGGGGGGGGGGGGGGGGGGGGGGGGGGGGGGGGGGGGGGGGGGGGGGGGGGGGGGGGGGGGGGGGGGGGGGGGGGGGGGGGGGGGGGGGGGGGGGGGGGGGGGGGGGGGGGGGGGGGGGGGGGGGGGGGGGGGGGGGGGGGGGGGGGGGGGGGGGGGGGGGGGGGGGGGGGGGGGGGGGGGGGGGGGGGGGGGGGGGGGGGGGGGGGGGGGGGGGGGGGGGGGGGGGGGGGGGGGGGGGGGGGGGGGGGGGGGGGGGGGGGGGGGGGGGGGGGGGGGGGGGGGGGGGGGGGGGGGGGGGGGGGGGGGGGGGGGGGGGGGGGGGGGGGGGGGGGGGGGGGGGGGGGGGGGGGGGGGGGGGGGGGGGGGGGGGGGGGGGGGGGGGGGGGGGGGGGGGGGGGGGGGGGGGGGGGGGGGGGGGGGGGGGGGGGGGGGGGGGGGGGGGGGGGGGGGGGGGGGGGGGGGGGGGGGGGGGGGGGGGGGGGGGGGGGGGGGGGGGGGGGGGG