WWWWWWWWWWWWWWW.............................................................................................................................................................................................................................................................................................................................................................................................................................................................................................................................................................................................................................................................
WWWWWWWWWWWWWWW.............................................................................................................................................................................................................................................................................................................................................................................................................................................................................................................................................................................................................................................................
WWWWWWWWWWWWWWW.............................................................................................................................................................................................................................................................................................................................................................................................................................................................................................................................................................................................................................................................
WWWWWWWWWWWWWWW.............................................................................................................................................................................................................................................................................................................................................................................................................................................................................................................................................................................................................................................................
WWWWWWWWWWWWWWW...............................................................................................................1...1.........................................................................................................................................................................................................................................................................................................................................................................................................................................................................................................................................
WWWWWWWWWWWWWWW....................................................................................................1...WW..WWWWWWWWWWWW........................................................................................................................................................WWWAWWWwwWWW............................................................................................................................................................................................................................................WWWWWWWWWWWW............................................................................................................
WWWWWWWWWWWWWWW..................................................................................................WWW.......WWWWWWWWWWWW........................................................................................................................................................WW.......WWW............................................................................................................................................................................................................................................WWWWWWWWWWWW............................................................................................................
WWWWWWWWWWWWWWW.............................................................................................WW.............WWWWWWWWWWWW........................................................................................................................................................WWWW....WWWW............................................................................................................................................................................................................................................WWWWWWWWWWWW............................................................................................................
WWWWWWWWWWWWWWW............................................................................................................WWWWWWWWWWWW........................................................................................................................................................ww.......WWW............................................................................................................................................................................................................................................WWWWWWWWWWWW............................................................................................................
WWWWWWWWWWWWWWW...........................................................................................WW..WA...........WWWWWWWWWWWW.......................................................................................................................................................WWWWWWWWWWWWW............................................................................................................................................................................................................................................WWWWWWWWWWWW............................................................................................................
WWWWWWWWWWWWWWW............................................................................................................WWWWWWWWWWWW..................................................................................................................................................WW....WWWWWWWWWWWW............................................................................................................................................................................................................................................WWWWWWWWWWWW............................................................................................................
WWWWWWWWWWWWWWW..............................................................................................WWWW..........WWWWWWWWWWWW........................................................................................................................................................WWWWWWWWWWWW............................................................................................................................................................................................................................................WWWWWWWWWWWW............................................................................................................
WWWWWWWWWWWWWWW.....................................................................................................WA.....WWWWWWWWWWWW......................................................................................................................................................WWWWWWWWWWWWWW............................................................................................................................................................................................................................................WWWWWWWWWWWW............................................................................................................
WWWWWWWWWWWWWWW............................................................................................................WWWWWWWWWWWW................................................................................................................................WAWW....................WWWWWWWWWWWW............................................................................................................................................................................................................................................WWWWWWWWWWWW............................................................................................................
WWWWWWWWWWWWWWW......................................................................................................WW....WWWWWWWWWWWW.................................................................................................................................................WWW....ww........WW............................................................................................................................................................................................................................................WWWWWWWWWWWW............................................................................................................
WWWWWWWWWWWWWWW............................................................................................................wwwwwwwwWWWW...............................................................................................................................WWW......1............WWWWWWWW.....WW............................................................................................................................................................................................................................................WWWWWWWWWWWW............................................................................................................
WWWWWWWWWWWWWWW..........................................................................................................WWWWWWWAwwWWWW.....................................................................................................................................WWWW...............WW......AWWW............................................................................................................................................................................................................................................WWWWWWWWWWWW............................................................................................................
WWWWWWWWWWWWWWW............................................................................................................WWWwwwwwWWWW..........................................................................................................................WWW.................1.........WW......1.WW............................................................................................................................................................................................................................................WWWWWWWWWWWW............................................................................................................
WWWWWWWWWWWWWWW............................................................................................................WWWwwwwWWWWW..................................................................................................................BBBBB.....................WWWW......WAWW....WWWWWW............................................................................................................................................................................................................................................WWWWWWWWWWWW............................................................................................................
WWWWWWWWWWWWWWW............................................................................................................WWWww1WWWWWW.................................................................................................................BBWWWBB................................WW........WW............................................................................................................................................................................................................................................WWWWWWWWWWWW............................................................................................................
WWWWWWWWWWWWWWW............................................................................................................WWwwAWWWWWWW........................................WW......................................................................BBWWWWWBB...........................WWWWWW..WA....WW............................................................................................................................................................................................................................................WWWWWWWWWWWW............................................................................................................
WWWWWWWWWWWWWWW.............................................................................................................wwwwWWWWWWW..............................WW...............................................................................BB.......BB..............................WW........WW............................................................................................................................................................................................................................................WWWWWWWWWWWW............................................................................................................
WWWWWWWWWWWWWWW.........................................................................................................WWWWWWWWWWWWWWW...................................WWW.......WWW..............................................................BB...WAW...BB.......................WW....WWWAWW....WW............................................................................................................................................................................................................................................WWWWWWWWWWWW............................................................................................................
WWWWWWWWWWWWWBBB...................................BBbbBBB.........................................................WW......WWWWWWWWWWWW........................WAWW.................................................................................bb...........BB............................WW1.......WW............................................................................................................................................................................................................................................WWWWWWWWWWWW............................................................................................................
WWWWWWWWWWWWWWPPBB................................BBWWwWWBB................................................................wWWWWWWWWWWW....................................................WWW...............................................WWW...BB...WAWAWAW...BB.................WW........WWWWWWWWwWWW............................................................................................................................................................................................................................................WWWWWWWWWWWW............................................................................................................
WWWWWWWWWWWWW....................1...............BBWWWwwWWBB...........................................................WW..wwWWWWWWWWWW......................WWWW........................................1...1..........................WW........BB........1......BB..........................WWWwwwwwwWWW............................................................................................................................................................................................................................................WWWWWWWWWWWW............................................................................................................
WWWWWWWWWWWWW.!.P...............BBB.............BBWWWWWwwwWBB..............BBB........................1BBB.................WwwwWWWWWWWW.................BBB...............BBB......................BbBBBBBBBBBBBBBBBB...WWW......................BBWWWWWWWWWWWW..WWWBB...........BBB...........WWWwwwwwWWWW............................................................................................................................................................................................................................................WWWWWWWWWWWW............................................................................................................
WWWWWWWWWWWWWWPPP..............BBBBB...........BBWWWWWWAwwWWBB....WW......BBBBB.......................BBBBB................WWwwWWWWWWWW................BBBBB.............BBBBB....................BB................BB.............BBB.............WWWWWWWWWWW..WWWW............BBBBB..........WWWwwwwwWWWW............................................................................................................................................................................................................................................WWWWWWWWWWWW............................................................................................................
WWWWWWWWWWWWWWWW..............BBWWWBB.........BBWWWWWwwwwWWWWBB..........BBWWWBB...............WW....bBWWWBB...............WWwwWWWWWWWW...............bbwWWBB...........BBWWWBB..................BBWP...WAWW..WAWA...BB...........BBBBB............WW.1........WWWWW...........BBW.WBB.........WWwwWWWWWWWW............................................................................................................................................................................................................................................WWWWWWWWWWWW............................................................................................................
WWWWWWWWWWWWWWW..............BBWW.WWBB..........WwwwwwwWWWWWW...........BBWW.WWBB...........1.......BbwW.WWBB..............WwwWWC1WWWWW.......WWW....BBWwwWWBB.........BBWW.WWBB................BBWWPP........1.......BB.........BBWWWBB...........WW.WAWAW...WWWWWW..........BBWWWWWBB........WWwwWC2WWWWW............................................................................................................................................................................................................................................WWWWWC3WWWWW............................................................................................................
WWWWWWWWWWWWWWW.............BBWWWWWWWBB.........WWwwAWWWWWWWW..........BBWWWWWWWBB.........WW......BBWwwwWWWBB.............wwWWW..WWWWW..WW.........BBWWWwWWWBB.......BBWWWWWWWBB..............BBWWWWWWWWWWWWWWWWWWWWWWBB.......BBWW.WWBB..........WW........WWWWWWW.........BBWWWWWWWBB.......WwwWW..WWWWW............................................................................................................................................................................................................................................WWWWW..WWWWW............................................................................................................
WWWWWWWWWWWWWWW...............WWWWWWW...........WWwwwWWWWWWWW............WWWWWWW.....WWW.............WWwAWWW...............WWWWWWWWWWWW...............WWWAWWW...........WWWWWWW..................WWWWWWWWWWWWWWWWWWWWWW........BBWWWWWWWBB.........WWWWWWWWWWWWWWWWW...........WWWWWWW.........wwWWWWWWWWWW...............PPPPPPP...........PPPPPPP..................PPPPPPP.....................PPPPPPP...........PPPPPPP..................PPPPPPP.....................PPPPPPP.....................PPPPPPP..................PPPPPPP...................WWWWWWWWWWWW............................................................................................................
WWWWWWWWWWWWWWW.......PPP.....WWW.WWW...........PppPPP.PPPPPP............WWW.WWW.....................WWw.WWW.............WWWWWWWWWWWWWW....WW.........WWW.WWW...........WWW.WWW..................WWW.WWWWWWWWWWWWWWWWWW..........WWW.WWW...........WWWWWWWW.WWWWWWWW...........WWW.WWW...WWAW..WWWWWWWWWWWW...............WWW.WWW...........WWW.WWW..................WWW.WWW.....................WWW.WWW...........WWW.WWW..................WWW.WWW.....................WWW.WWW.....................WWW.WWW..................WWW.WWW...................WWWWWWWWWWWW............................................................................................................
WWWWWWWWWWWWWWW.....PPPPPP....PPP.PPP...........ppPPPP.PPPPPP............PPP.PPP.....................PPP.ppp.........1.....WWWWWWWWWWWW...............ppp.PPP...........PPP.PPP..................PPP.PPPPPPPPPPPPPPPPPP..........PPP.PPP...........PPPPPPPP.PPPPPPPP...........PPP.PPP.........WWWWWWWWWWWW...............PPP.PPP...........PPP.PPP..................PPP.PPP.....................PPP.PPP...........PPP.PPP..................PPP.PPP.....................PPP.PPP.....................PPP.PPP..................PPP.PPP...................WWWWWWWWWWWW............................................................................................................
GGGGGGGGGGGGGGGGGGGGGGGGGGGGGGGGGGGGGGGGGGGGGGGGGGGGGGGGGGGGGGGGGGGGGGGGGGGGGGGGGGGGGGGGGGGGGGGGGGGGGGGGGGGGGGGGGGGGGGGGGGGGGGGGGGGGGGGGGGGGGGGGGGGGGGGGGGGGGGGGGGGGGGGGGGGGGGGGGGGGGGGGGGGGGGGGGGGGGGGGGGGGGGGGGGGGGGGGGGGGGGGGGGGGGGGGGGGGGGGGGGGGGGGGGGGGGGGGGGGGGGGGGGGGGGGGGGGGGGGGGGGGGGGGGGGGGGGGGGGGGGGGGGGGGGGGGGGGGGGGGGGGGGGGGGGGGGGGGGGGGGGGGGGGGGGGGGGGGGGGGGGGGGGGGGGGGGGGGGGGGGGGGGGGGGGGGGGGGGGGGGGGGGGGGGGGGGGGGGGGGGGGGGGGGGGGGGGGGGGGGGGGGGGGGGGGGGGGGGGGGGGGGGGGGGGGGGGGGGGGGGGGGGGGGGGGGGGGGGGGGGGGGGGGGGGGGGGGGGGGGGGGGGGGGGGGGGGGGGGGGGGGGGGGGGGGGGGGGGGGGGGGGGGGGGGGGGGGGGGGGGGGGGGGGGGGGGGGGGGGGGGGGGGGGGGGGGGGGGGGGGGGGGGGGGGGGGGGGGGGGGGGGGGGGGGGGGG
GGGGGGGGGGGGGGGGGGGGGGGGGGGGGGGGGGGGGGGGGGGGGGGGGGGGGGGGGGGGGGGGGGGGGGGGGGGGGGGGGGGGGGGGGGGGGGGGGGGGGGGGGGGGGGGGGGGGGGGGGGGGGGGGGGGGGGGGGGGGGGGGGGGGGGGGGGGGGGGGGGGGGGGGGGGGGGGGGGGGGGGGGGGGGGGGGGGGGGGGGGGGGGGGGGGGGGGGGGGGGGGGGGGGGGGGGGGGGGGGGGGGGGGGGGGGGGGGGGGGGGGGGGGGGGGGGGGGGGGGGGGGGGGGGGGGGGGGGGGGGGGGGGGGGGGGGGGGGGGGGGGGGGGGGGGGGGGGGGGGGGGGGGGGGGGGGGGGGGGGGGGGGGGGGGGGGGGGGGGGGGGGGGGGGGGGGGGGGGGGGGGGGGGGGGGGGGGGGGGGGGGGGGGGGGGGGGGGGGGGGGGGGGGGGGGGGGGGGGGGGGGGGGGGGGGGGGGGGGGGGGGGGGGGGGGGGGGGGGGGGGGGGGGGGGGGGGGGGGGGGGGGGGGGGGGGGGGGGGGGGGGGGGGGGGGGGGGGGGGGGGGGGGGGGGGGGGGGGGGGGGGGGGGGGGGGGGGGGGGGGGGGGGGGGGGGGGGGGGGGGGGGGGGGGGGGGGGGGGGGGGGGGGGGGGGGGGG