WWWWWWWWWWWWWWW...............................................................................................................................................................WWWWWWWWWWWWWWWWWWWW
WWWWWWWWWWWWWWW...............................................................................................................................................................WWWWWWWWWWWWWWWWWWWW
WWWWWWWWWWWWWWW...............................................................................................................................................................WWWWWWWWWWWWWWWWWWWW
WWWWWWWWWWWWWWW...............................................................................................................................................................WWWWWWWWWWWWWWWWWWWW
WWWWWWWWWWWWWWW...............................................................................................................................................................WWWWWWWWWWWWWWWWWWWW
WWWWWWWWWWWWWWW..............................................................................W................................................................................WWWWWWWWWWWWWWWWWWWW
WWWWWWWWWWWWWWW..................................................................................WWWW.........................................................................WWWWWWWWWWWWWWWWWWWW
WWWWWWWWWWWWWWW...........................................................................W...................................................................................WWWWWWWWWWWWWWWWWWWW
WWWWWWWWWWWWWWW...............................................................................................................................................................WWWWWWWWWWWWWWWWWWWW
WWWWWWWWWWWWWWW..............................................................................WW..........WWWW.................................................................WWWWWWWWWWWWWWWWWWWW
WWWWWWWWWWWWWWW...............................................................................................................................................................WWWWWWWWWWWWWWWWWWWW
WWWWWWWWWWWWWWW..................................................................................WWW..........................................................................WWWWWWWWWWWWWWWWWWWW
WWWWWWWWWWWWWWW........................................................................................W......................................................................WWWWWWWWWWWWWWWWWWWW
WWWWWWWWWWWWWWW...............................................................................................WWWW............................................................WWWWWWWWWWWWWWWWWWWW
WWWWWWWWWWWWWWW....................................................................................WW.........................................................................WWWWWWWWWWWWWWWWWWWW
WWWWWWWWWWWWWWW.........................................................................WWWW...W.....................WWWW.....................................................WWWWWWWWWWWWWWWWWWWW
WWWWWWWWWWWWWWW.....................................................w.W.W.w.w.w.W.W.W..............................................E..........................................WWWWWWWWWWWWWWWWWWWW
WWWWWWWWWWWWWWW.....................................................WwwWWWwwwwwwWWWWW.......................................GGGGGGGGGGGGGGGGGGGGGGGGGGGGGGggggggggggGGGGGGGGGGGGGGGGGGGGWWWWWWWWWW
WWWWWWWWWWWWWWW..................................WWW............WW...WwW.........WWW.WW.................................................................................................WWWWWWWWWW
WWWWWWWWWWWWWWW.......................................W..............WwW.....E.....W....................................................................................................WWWWWWWWWW
WWWWWWWWWWWWWWW..............................WW............WWW.......W.....WWWWWWW.W.....WA.............................................................................................WWWWWWWWWW
WWWWWWWWWWWWWWW.......................................EW.............WWWWWW......wwW....................................................................................................WWWWWWWWWW
WWWWWWWWWWWWWWW..................................WW..................WWWWW..WWAWWWww.....WWW............................................................................................WWWWWWWWWW
WWWWWWWWWWWWWWW......................................WWW........W....WWWWWW.......wWWW..................................................................................................WWWWWWWWWW
WWWWWWWWWWWWWWW............................................WW........w.....WWWWWWWWW....................................................................................................WWWWWWWWWW
WWWWWWWWWWWWWWW....................................................WWWW...........WW....................................................................................................WWWWWWWWWW
WWWWWWWWWWWWWWW......................................................W....WWWAWWWAWW....................................................................................................WWWWWWWWWW
WWWWWWWWWWWWWWW......................................................WWW...........W...............................................................W....................................WWWWWWWWWW
WWWWWWWWWWWWWWW......................................................W..E..........w...............................................................W....................................WWWWWWWWWW
WWWWWWWWWWWWWWW......................................................WWWWWWWWWWWWWWWWWW.........WWAW...............................................W....................................WWWWWWWWWW
WWWWWWWWWWWWWWW......................................................WWWWWWWWWWWWWWW......WW.......................................................W....................................WWWWWWWWWW
WWWWWWWWWWWWWWW......................................................WWWWWWWWWWWWWWW....W......WWWWWW...............................................W...................................WWWWWWWWWW
WWWWWWWWWWWWWWW......................................................WWWWWWWCCWWWWWW..W.................WW..........................................W...................................WWWWWWWWWW
WWWWWWWWWWWWWWW......................................................WWWWWWWECwwwwww................................................................W...................................WWWWWWWWWW
WWWWWWWWWWWWWWW.................................E.....WWWW..........GGGGGGGGGGGGGGGGGGG.....................WWWW.....................................W..................................WWWWWWWWWW
WWWWWWWWWWWWWWW.............................WWWWWWW...........WW...AGGG......GGGGGGGGGG.................WA...........................................W..................................WWWWWWWWWW
WWWWWWWWWWWWWWW........................AW...............................GGGG...GGGGGGG................................................................W.................................WWWWWWWWWW
WWWWWWWWWWWWWWW...............WWWW...............................GGGGGGGGG.GGG....GGGG.................WWWW...........................................W.................................WWWWWWWWWW
WWWWWWWWWWWWWWW.......................WWWWW.......................GGGGGG..GGGGGGG.G...AWW........WWW...................................................W................................WWWWWWWWWW
WWWWWWWWWWWWWWW.......WAWWWW......................................G.GGGG.GG.GG.GG.......WW.............................................................W................................WWWWWWWWWW
WWWWWWWWWWWWWWW.WWW...............................................GG.G....GG.....GGGWW.......WW.........................................................W.......................WWW.....WWWWWWWWWW
WWWWWWWWWWWWWWW....................................................GG....GG......GG....WWWW.............................................................W......................W...W....WWWWWWWWWW
WWWWWWWWWWWWWWW....WWWAW............................................GG....GG....GG.......................................................................W.....................w...W....WWWWWWWWWW
WWWWWWWWWWW.P......................................................GG....................................................................................W.....................w...W....WWWWWWWWWW
GGGWWGWWGGGWWWWWWW....G...................................................................................................................................GGGGGGGGGGGGGGGGGGGGGGGFGGGGGGGGGGGGGGGG
GGGGWGGGGGWWW......GG.............................................................................................................................................................................
GGGGGWGGWGGW......................................................................................................................................................................................
GGGGGGGGGWW.......................................................................................................................................................................................