WWWWWWWWWWW.................................................................................................................................................................................................................................................................................................................WWWWWWWWWWW
WWWWWWWWWWW.................................................................................................................................................................................................................................................................................................................WWWWWWWWWWW
WWWWWWWWWWW.....................................................W.W.W.W.W.W.W.W.W...........................................................................................................................................................................................................................................WWWWWWWWWWW
WWWWWWWWWWW.....................................................WWWWWWWWWWWWWWWWW...........................................................................................................................................................................................................................................WWWWWWWWWWW
WWWWWWWWWWW......................................................WWWWWWWWWWWWWWW............................................................................................................................................................................................................................................WWWWWWWWWWW
WWWWWWWWWWW......................................................WWWWWW..WWWWWWW............................................................................................................................................................................................................................................WWWWWWWWWWW
WWWWWWWWWWW......................................................WWWWWWW..WWWWWW............................................................................................................................................................................................................................................WWWWWWWWWWW
WWWWWWWWWWW......................................................wwwwwww..WWWWWW............................................................................................................................................................................................................................................WWWWWWWWWWW
WWWWWWWWWWW........................................WWWW.........GGGGGGGGGGGGGGGGGGG.........................................................................................................................................................................................................................................WWWWWWWWWWW
WWWWWWWWWWW..............................WWWWWWW..........WW...AGGG......GGGGGGGGGG.........................................................................................................................................................................................................................................WWWWWWWWWWW
WWWWWWWWWWW.........................AW..............................GGGG...GGGGGGG..........................................................................................................................................................................................................................................WWWWWWWWWWW
WWWWWWWWWWW................WWWW..............................GGGGGGGGG.GGG....GGGG..........................................................................................................................................................................................................................................WWWWWWWWWWW
WWWWWWWWWWW.......................WWWWWWW.....................GGGGGG..GGGGGGG.G...AWW.......................................................................................................................................................................................................................................WWWWWWWWWWW
WWWWWWWWWWW.......WAWWWW......................................G.GGGG.GG.GG.GG...........WWW.................................................................................................................................................................................................................................WWWWWWWWWWW
WWWWWWWWWWW.WWW...............................................GG.G....GG.....GGGWW..................WWWA....................................................................................................................................................................................................................WWWWWWWWWWW
WWWWWWWWWWW.P..................................................GG....GG......GG....WWWW......WWWW...........................................................................................................................................................................................................................WWWWWWWWWWW
WWWWWWWWWWW....WWWAW............................................GG....GG....GG...........................WWWWW..............................................................................................................................................................................................................WWWWWWWWWWW
WWWWWWWWWWW....................................................GG...........................................................................................................................................................................................................................................................WWWWWWWWWWW
WWWWWWWWWWGGGGGGGGGGGGGGGGGGGGGG.................................................................WWWW...................GGG..WWGGGGGGGGGGGGGGGGGGGGGGGGGGGGGGGGGGGGGGGGGGGGGGGGGGGGGGGGGGGGGGGGGGGGGGGGGGGGGGGGGGGGGGGGGGGGGGGGGGGGGGGGGGGGGGGGGGGGGGGGGGGGGGGGGGGGGGGGGGGGGGGGGGGGGGGGGGGGGGGGGGGGGGGGGGGGGGGGGGGGGGGGGGGGGGWWWWWWWWWW
WWWWWWWWWGGGGGGGGGGGGGGGGGGGGGGG................................................................................WWW.........WWGGGGGGGGGGGGGGGGGGGGGGGGGGGGGGGGGGGGGGGGGGGGGGGGGGGGGGGGGGGGGGGGGGGGGGGGGGGGGGGGGGGGGGGGGGGGGGGGGGGGGGGGGGGGGGGGGGGGGGGGGGGGGGGGGGGGGGGGGGGGGGGGGGGGGGGGGGGGGGGGGGGGGGGGGGGGGGGGGGGGGGGGGGGGGGGGWWWWWWWWW
WWWWWWWWGGGGGGGGGGGGGGGGGGGGGGGG..........................................................................WWW.........WWWWWWWGGGGGGGGGGGGGGGGGGGGGGGGGGGGGGGGGGGGGGGGGGGGGGGGGGGGGGGGGGGGGGGGGGGGGGGGGGGGGGGGGGGGGGGGGGGGGGGGGGGGGGGGGGGGGGGGGGGGGGGGGGGGGGGGGGGGGGGGGGGGGGGGGGGGGGGGGGGGGGGGGGGGGGGGGGGGGGGGGGGGGGGGGGGGGGGGGGWWWWWWWW
WWWWWWWGGGGGGGGGGGGGGGGGGGGGGGGG........................................................................................GGGGGGGGGGGGGGGGGGGGGGGGGGGGGGGGGGGGGGGGGGGGGGGGGGGGGGGGGGGGGGGGGGGGGGGGGGGGGGGGGGGGGGGGGGGGGGGGGGGGGGGGGGGGGGGGGGGGGGGGGGGGGGGGGGGGGGGGGGGGGGGGGGGGGGGGGGGGGGGGGGGGGGGGGGGGGGGGGGGGGGGGGGGGGGGGGGGGGGGGWWWWWWW