GGGGGGGG.....................................................................................GGGGGG
GGGGGGGG.................................................................................I...GGGGGG
GGGGGGGG....GGGGGG..........................GGGG....GGG.........................GGG......I...GGGGGG
GGGGGGGG............................GGGG............GGG........................GGGG......I...GGGGGG
GGGGGGGG.............GG..GG.........................GGG.......................GGGGG......I...GGGGGG
GGGGGGGG.......................GGG..................GGG......................GGGGGG......I...GGGGGG
GGGGGGGG.........GGGG...............................GGG.....................GGGGGGG......I...GGGGGG
GGGGGGGG...................................................................GGGGGGGG......I...GGGGGG
GGGGGGGGGGGGGGGGGGG...GGGGGGGGGGGGGGGGGGGG....GGGGGGGGGGGGGGGGGGGGGGGGGGGGGGGGGGGGGGGGGGGGGGGGGGGGG