WWWWWWWWWW.....................................................................................WWWWWWWWWW
WWWWWWWWWW.....................................................................................WWWWWWWWWW
WWWWWWWWWW.....................................................................................WWWWWWWWWW
WWWWWWWWWW.....................................................................................WWWWWWWWWW
WWWWWWWWWW.....................................................................................WWWWWWWWWW
WWWWWWWWWW.....................................................................................WWWWWWWWWW
WWWWWWWWWW.....................................................................................WWWWWWWWWW
WWWWWWWWWW......................................A..............................................WWWWWWWWWW
WWWWWWWWWW.................................................................................I...WWWWWWWWWW
WWWWWWWWWW....GGGGGG.........................GGGGGG...GGG.........................GGG......I...WWWWWWWWWW
WWWWWWWWWW............................GGGG............GGG........................GGGG......I...WWWWWWWWWW
WWWWWWWWWW.............AG..GG.........................GGG.......................GGGGG......I...WWWWWWWWWW
WWWWWWWWWW.......................GGG..................GGG......................GGGGGG......I...WWWWWWWWWW
WWWWWWWWWW.P.......GAGG...............................GGG.....................GGGGGGG......I...WWWWWWWWWW
WWWWWWWWWW........E...........E.......................GG.....................GGGGGGGG......I...WWWWWWWWWW
GGGGGGGGGGGGGGGGGGGGG...GGGGGGGGGGGGGGGGGGGG....GGGGGGG..GGGGGGGGGGGGGGGGGGGGGGGGGGGGGGGGGGFGGGGGGGGGGGGG
GGGGGGGGGGGGGGGGGGGGG....GGGGGGGGGGGGGGGGGG......GGGGG..GGGGGGGGGGGGGGGGGGGGGGGGGGGGGGGGGGGGGGGGGGGGGGGGG
GGGGGGGGGGGGGGGGGGGGG..................................GGGGGGGGGGGGGGGGGGGGGGGGGGGGGGGGGGGGGGGGGGGGGGGGGG
GGGGGGGGGGGGGGGGGGGGG...GGGGGGGGGGGGGGGGGGGG....GGGGGGGGGGGGGGGGGGGGGGGGGGGGGGGGGGGGGGGGGGGGGGGGGGGGGGGGG