W............................................................................................W.......
.....................................................................................................
.....................................................................................................
.....................................................................................................
.........................................................................................I...........
............GGGGGG.........................GGGGG....GGG.........................GGG......I...........
....................................GGGG............GGG........................GGGG......I...........
.....................GG..GG.........................GGG.......................GGGGG......I...........
...............................GGG..................GGG......................GGGGGG......I...........
.................GGGG...............................GGG.....................GGGGGGG......I...........
.........................G.................................................GGGGGGGG......I...........
B....................................................................................................