GGGGGGGGGG.....................................................................................GGGGGGGGGG
GGGGGGGGGG.....................................................................................GGGGGGGGGG
GGGGGGGGGG.....................................................................................GGGGGGGGGG
GGGGGGGGGG.................................................................................I...GGGGGGGGGG
GGGGGGGGGG....GGGGGG.........................GGGGG....GGG.........................GGG......I...GGGGGGGGGG
GGGGGGGGGG............................GGGG............GGG........................GGGG......I...GGGGGGGGGG
GGGGGGGGGG.............GG..GG.........................GGG.......................GGGGG......I...GGGGGGGGGG
GGGGGGGGGG.......................GGG..................GGG......................GGGGGG......I...GGGGGGGGGG
GGGGGGGGGG.........GGGG...............................GGG.....................GGGGGGG......I...GGGGGGGGGG
GGGGGGGGGG............................................GGG....................GGGGGGGG......I...GGGGGGGGGG
GGGGGGGGGGGGGGGGGGGGG...GGGGGGGGGGGGGGGGGGGG....GGGGGGGGGGGGGGGGGGGGGGGGGGGGGGGGGGGGGGGGGGGGGGGGGGGGGGGGG